BBB                P
BB                 B
BE                 B
BB                 B
BBB                B
BB                 B
BE                 B
BB                 B
BBB                B
BB                 B
BE                 B
BB                 B
BBB                B
BB                 B
BE                 B
BB                 B
BBB                B
BB                 B
BF                 B
BBBBBBBBBBBBBBBBBBBB